5
1 0 0 0 1
1 1 1 1 0
0 0 1 0 1
0 1 1 1 0
0 0 0 0 1
7
1 0 0 0 0 1 1
1 1 1 1 0 1 0
0 0 1 0 0 1 0
0 1 1 1 0 1 0
0 1 0 1 0 1 0
0 1 0 1 1 1 0
0 1 0 1 0 0 1
7
1 0 0 0 0 1 0
1 1 1 1 0 1 0
0 0 1 0 0 1 0
0 1 1 1 0 1 0
0 1 0 1 0 1 0
0 1 0 1 1 1 0
0 1 0 1 0 1 0
7
1 0 1 1 0 1 0
1 1 1 1 1 1 0
0 0 1 0 0 0 1
0 1 1 1 1 1 1
0 1 0 1 0 1 0
1 1 1 1 1 1 0
0 1 0 1 0 1 0
10
1 0 1 1 0 1 0 1 1 1
1 1 1 1 1 1 0 1 0 1
0 0 1 0 0 0 1 1 1 1
0 1 1 1 1 1 1 1 0 1
0 1 0 1 0 1 0 1 0 1
1 1 1 1 1 1 0 1 1 1
0 1 0 1 0 1 0 0 0 1
0 1 1 1 0 1 0 0 0 0
0 1 0 1 0 1 0 1 1 1
0 1 1 1 1 1 0 1 1 1
10
1 0 1 1 0 1 1 1 1 0
1 1 1 1 1 1 0 1 0 1
0 0 1 0 0 0 1 1 1 0
0 1 1 1 1 1 1 1 0 1
0 1 0 1 0 1 0 1 0 1
1 1 1 1 1 1 0 1 1 0
0 1 0 1 0 1 0 0 0 0
0 1 1 1 0 1 0 0 1 1
0 1 0 1 0 1 0 1 1 1
0 1 1 1 1 1 0 1 1 1